...........#..####.....########......#..............................#.......#...........................................
...........#..##++............?......#..............................#.......#...........................................
...........#..##++............?......#..............................#.......#...........................................
...........#..####............?......#..............................#.......#...........................................
...........#...###....#########......#..............................#.......#...........................................
...........#.........#.#......#......#..............................#.......#...........................................
...........#........#..#......#......#..............................#.......#...........................................
...........#...........#......#......#.....................##########.......######......................................
...........#############......#......#.....................#.....................#......................................
..............................#......#.....................#.....................#......................................
..............................#......#.....................#..#######............#......................................
..............................#......#.....................#..######.............#......................................
..............................#......#.....................#..##.................#......................................
................###############......######................#..##.................#......................................
................#.........................#................#..##.................#......................................
................#.........................#................#..##.................#......................................
................#.........................##################..#......!!!.........#......................................
................#..##########....#######.............................!!!.........#......................................
................#..##########....#######.............................!!!......#..#......................................
................#............................................................##..#......................................
................#............................................................##..#......................................
................#..##.....###++###....##.....................................##..#......................................
................#..##.....###++###....##..##################.................##..#......................................
................#.........................#................#.............######..#......................................
................#.........................#................#............#######..#......................................
................#..#########....########..#................#.....................#......................................
................#..#########....########..#................#.....................#......................................
................#.........................#................#.....................#......................................
................#.........................#................#######################......................................
................###########################.............................................................................