...#################......################............................................................................................................
...#...............########..............#............................................................................................................
...#..........................#########..#............................................................................................................
...#..########................#########..#.............................###............................................................................
...#..########.......................##..#............................#####...........................................................................
...#..##.............................##..#...........................##...##..........................................................................
...#..##........................!!!..##..#..........................##.....##.........................................................................
...#..##........................!!!..##..#.........................##.......##........................................................................
...#..##...........########.....!!!..##..#........................##...###...##.......................................................................
...#..##...........#......#..........##..#.......................##...#####...##......................................................................
...#..##...........#......#..........##..#......................##...##...##...##.....................................................................
...#..##...........#......#.##...........#.....................##...##.....##...##....................................................................
...#..##...........#......#.##...........#....................##.................##...................................................................
...#..########.....#......#.##...........#...................##...................##..................................................................
...#..########.....#......#.####.........#..................##.....................##.................................................................
...#...............#......#.####.........#.................##......#...!!!...#......##................................................................
...#...............#......#..............#................##......##...!!!...##......##...............................................................
...#################......#####......#####...............##......##....!!!....##......##..............................................................
..............................#......#....................##....##.............##....##...............................................................
..............................#......#.....................##....##...........##....##................................................................
..............................#......#......................##....##.........##....##.................................................................
..............................#......#.......................##....##.......##....##..................................................................
..............................#......#........................##....#.......#....##...................................................................
..............................#......#.........................##...............##....................................................................
...........#############......#......#..........................##.............##.....................................................................
...........#...........#......#......#...........................##...........##......................................................................
...........#........#..#......#......#............................##.........##.......................................................................
...........#.........#.#......#......#.............................##.......##........................................................................
...........#...###....#########......#..............................#.......#.........................................................................
...........#..####............?......#..............................#.......#.........................................................................
...........#..##++............?......#..............................#.......#.........................................................................
...........#..##++............?......#..............................#.......#.........................................................................
...........#..####............?......#..............................#.......#.........................................................................
...........#...###....#########......#..............................#.......#.........................................................................
...........#.........#.#......#......#..............................#.......#.........................................................................
...........#........#..#......#......#..............................#.......#.........................................................................
...........#...........#......#......#.....................##########.......######....................................................................
...........#############......#......#.....................#.....................#....................................................................
..............................#......#.....................#.....................#....................................................................
..............................#......#.....................#..#######............#....................................................................
..............................#......#.....................#..######.............#....................................................................
..............................#......#.....................#..##.................#....................................................................
................###############......######................#..##.................#....................................................................
................#.........................#................#..##.................#....................................................................
................#.........................#................#..##.................#....................................................................
................#.........................##################..#......!!!.........#....................................................................
................#..##########....#######.............................!!!.........#....................................................................
................#..##########....#######.............................!!!......#..#....................................................................
................#............................................................##..#....................................................................
................#............................................................##..#....................................................................
................#..##.....###++###....##.....................................##..#....................................................................
................#..##.....###++###....##..##################.................##..#....................................................................
................#.........................#................#.............######..#....................................................................
................#.........................#................#............#######..#....................................................................
................#..#########....########..#................#.....................#....................................................................
................#..#########....########..#................#.....................#....................................................................
................#.........................#................#.....................#....................................................................
................#.........................#................#######################....................................................................
................###########################...........................................................................................................
