...#################......################..............................................................................
...#...............########..............#..............................................................................
...#..........................#########..#..............................................................................
...#..########................#########..#.............................###..............................................
...#..########.......................##..#............................#####.............................................
...#..##.............................##..#...........................##...##............................................
...#..##........................!!!..##..#..........................##.....##...........................................
...#..##........................!!!..##..#.........................##.......##..........................................
...#..##...........########.....!!!..##..#........................##...###...##.........................................
...#..##...........#......#..........##..#.......................##...#####...##........................................
...#..##...........#......#..........##..#......................##...##...##...##.......................................
...#..##...........#......#.##...........#.....................##...##.....##...##......................................
...#..##...........#......#.##...........#....................##.................##.....................................
...#..########.....#......#.##...........#...................##...................##....................................
...#..########.....#......#.####.........#..................##.....................##...................................
...#...............#......#.####.........#.................##......#...!!!...#......##..................................
...#...............#......#..............#................##......##...!!!...##......##.................................
...#################......#####......#####...............##......##....!!!....##......##................................
..............................#......#....................##....##.............##....##.................................
..............................#......#.....................##....##...........##....##..................................
..............................#......#......................##....##.........##....##...................................
..............................#......#.......................##....##.......##....##....................................
..............................#......#........................##....#.......#....##.....................................
..............................#......#.........................##...............##......................................
...........#############......#......#..........................##.............##.......................................
...........#...........#......#......#...........................##...........##........................................
...........#........#..#......#......#............................##.........##.........................................
...........#.........#.#......#......#.............................##.......##..........................................
...........#...###....#########......#..............................#.......#...........................................
