........................................................................................................................
........................................................................................................................
........................................................................................................................
...#################......################..............................................................................
...#...............########..............#..............................................................................
...#..........................#########..#..............................................................................
...#..########................#########..#.............................###..............................................
...#..########.......................##..#............................#####.............................................
...#..##.............................##..#...........................##...##............................................
...#..##........................!!!..##..#..........................##.....##...........................................
...#..##........................!!!..##..#.........................##.......##..........................................
...#..##...........########.....!!!..##..#........................##...###...##.........................................
...#..##...........#......#..........##..#.......................##...#####...##........................................
...#..##...........#......#..........##..#......................##...##...##...##.......................................
...#..##...........#......#.##...........#.....................##...##.....##...##......................................
...#..##...........#......#.##...........#....................##.................##.....................................
...#..########.....#......#.##...........#...................##...................##....................................
...#..########.....#......#.####.........#..................##.....................##...................................
...#...............#......#.####.........#.................##......#...!!!...#......##..................................
...#...............#......#..............#................##......##...!!!...##......##.................................
...#################......#####......#####...............##......##....!!!....##......##................................
..............................#......#....................##....##.............##....##.................................
..............................#......#.....................##....##...........##....##..................................
..............................#......#......................##....##.........##....##...................................
..............................#......#.......................##....##.......##....##....................................
..............................#......#........................##....#.......#....##.....................................
..............................#......#.........................##...............##......................................
...........#############......#......#..........................##.............##.......................................
...........#...........#......#......#...........................##...........##........................................
...........#........#..#......#......#............................##.........##.........................................
...........#.........#.#......#......#.............................##.......##..........................................
...........#...###....#########......#..............................#.......#...........................................
...........#..####............?......#..............................#.......#...........................................
...........#..##++............?......#..............................#.......#...........................................
...........#..##++............?......#..............................#.......#...........................................
...........#..####............?......#..............................#.......#...........................................
...........#...###....#########......#..............................#.......#...........................................
...........#.........#.#......#......#..............................#.......#...........................................
...........#........#..#......#......#..............................#.......#...........................................
...........#...........#......#......#.....................##########.......######......................................
...........#############......#......#.....................#.....................#......................................
..............................#......#.....................#.....................#......................................
..............................#......#.....................#..#######............#......................................
..............................#......#.....................#..######.............#......................................
..............................#......#.....................#..##.................#......................................
................###############......######................#..##.................#......................................
................#.........................#................#..##.................#......................................
................#.........................#................#..##.................#......................................
................#.........................##################..#......!!!.........#......................................
................#..##########....#######.............................!!!.........#......................................
................#..##########....#######.............................!!!......#..#......................................
................#............................................................##..#......................................
................#............................................................##..#......................................
................#..##.....###++###....##.....................................##..#......................................
................#..##.....###++###....##..##################.................##..#......................................
................#.........................#................#.............######..#......................................
................#.........................#................#............#######..#......................................
................#..#########....########..#................#.....................#......................................
................#..#########....########..#................#.....................#......................................
................#.........................#................#.....................#......................................
................#.........................#................#######################......................................
................###########################.............................................................................
........................................................................................................................
........................................................................................................................
........................................................................................................................
........................................................................................................................
........................................................................................................................
........................................................................................................................
........................................................................................................................
........................................................................................................................
........................................................................................................................
........................................................................................................................
........................................................................................................................
........................................................................................................................
........................................................................................................................
........................................................................................................................
........................................................................................................................
........................................................................................................................
........................................................................................................................
........................................................................................................................
