....................................................................................................
.........................................................................#########..................
.........................................................................##########.................
.........................................................................##.......##................
.........................................................................##........##...............
.........................................................................##.........##..............
........................................#########################........##..#####...##.............
........................................#..........##.###########........##..#####....##............
........................................#.......#..##........##############............##...........
........................................#.......##.######....#####.................##...##..........
........................................#.......##.#######...#####............!!!..##....##.........
........................................#....#..##............................!!!..##.....##........
........................................#....##.######........................!!!..##....##.........
........................................#....##.#######............................##...##..........
........................................#.#..##.................###########............##...........
....########################............#.##.######.............#........##..#####....##............
....#......................#............#.##.#######............#........##..#####...##.............
....#......................#............#.##....................#........##.........##..............
....#......##########......#............#.#####.................#........##........##...............
....#......##########......#............#.#######...............#........##.......##................
....#......##......##......#............#..................###..#........##########.................
....#......##......##......#............#############.....#######........#########..................
....#......##......##......#........................##....###.......................................
....#......##......##......#........................###.....#.......................................
....#......................#........................####....#.......................................
....#......................#........................####....#.......................................
....#......................#........................####....#.......................................
....#......................#........................####....#.......................................
....##########.....#########........................####....#.......................................
............###....#..............#############.....####....#.......................................
............####...#..............#...........#.....####...##.......................................
............#####..#..............#.###...###.#.....####.####.......................................
............#####..#..............#.###...###.#.....###..####.......................................
............#####..#..............#.###...###.#######??..####.......................................
............####...#..............#...............?????..####.......................................
............####..##..............#....+++........???....####.......................................
............###..###..............#....+++........#####...###.......................................
............##..####..............#....+++......########..###.......................................
............#...####..............#...........##########....#.......................................
............#++#####..............#.###...###.##########....#.......................................
............#++#####..............#.###...###.#.....####....#.......................................
............#..#####..............#.###...###.#.....####..###.......................................
............#..#####..............#...........#.....###...###.......................................
............##..####..............#############.....###...###.......................................
............##...###................................##...####.......................................
............###....#............................#####....#######....................................
....###########....########.....................#..............#....................................
....#....######........####.....................#.##....######.#....................................
....#.....####....####..###.....................#.##....######.#....................................
....#..............####.###.....................#.##........##.#....................................
....#....#...........##.###.....................#...........##.#....................................
....#....##...!!!....##.###.....................#.....!!!...##.#....................................
....##...##...!!!....##..##.....................#.....!!!...##.#....................................
....###..##...!!!.....#...#.....................#.....!!!....#.#....................................
....###..##...............#######################..............#....................................
....###..##...............######################...............#....................................
....####.########..........#####################.......#####...#....................................
....####..########.............#############........########...#....................................
....#######....................................................#....................................
....#########..................................................#....................................
....############################################################....................................
....................................................................................................
....................................................................................................
....................................................................................................
....................................................................................................
....................................................................................................
....................................................................................................
....................................................................................................
....................................................................................................
....................................................................................................
