............###....#..............#############.....####....#.......................................
............####...#..............#...........#.....####...##.......................................
............#####..#..............#.###...###.#.....####.####.......................................
............#####..#..............#.###...###.#.....###..####.......................................
............#####..#..............#.###...###.#######??..####.......................................
............####...#..............#...............?????..####.......................................
............####..##..............#....+++........???....####.......................................
............###..###..............#....+++........#####...###.......................................
............##..####..............#....+++......########..###.......................................
............#...####..............#...........##########....#.......................................
............#++#####..............#.###...###.##########....#.......................................
............#++#####..............#.###...###.#.....####....#.......................................
............#..#####..............#.###...###.#.....####..###.......................................
............#..#####..............#...........#.....###...###.......................................
............##..####..............#############.....###...###.......................................
............##...###................................##...####.......................................
............###....#............................#####....#######....................................
....###########....########.....................#..............#....................................
....#....######........####.....................#.##....######.#....................................
....#.....####....####..###.....................#.##....######.#....................................
....#..............####.###.....................#.##........##.#....................................
....#....#...........##.###.....................#...........##.#....................................
....#....##...!!!....##.###.....................#.....!!!...##.#....................................
....##...##...!!!....##..##.....................#.....!!!...##.#....................................
....###..##...!!!.....#...#.....................#.....!!!....#.#....................................
....###..##...............#######################..............#....................................
....###..##...............######################...............#....................................
....####.########..........#####################.......#####...#....................................
....####..########.............#############........########...#....................................
....#######....................................................#....................................